#################
# @           @ #
#      /    @ D #
# !@ @ @ @  @ ! #
#           #   #
#        @      #
#     @         #
#     @     #   #
#             @ #
#################
