#################
# @           @ #
# !    /    @ D #
#  @!    @      #
#     !     #   #
#        @      #
#     @         #
#     @     #   #
#        !!   @ #
#################
