#########################
# @           @         #
# !    /    @           #
#  @     @       #      #
#           #           #
#        @              #
#     @         #       #
#     @     #  !        #
#             @         #
#    #        @@@@@@    #
#         #  @ ! D @    #
#########################
