######
# /  #
#    #
#  @ #
######
######