####  ###########
# @           @ #
     /      @   #
#  @     @      #
#           #   #
#        @      #
#     @    D    #
#     @    ! #  #
#             @ #
#################
