######
# /  #
# !  #
#  @!#
######
######