#################
# @           @ #
# !    /    @   #
#  @!    @      #
#           #   #
#        @      #
#     @     D   #
#     @     #   #
#        !!   @ #
#################
