#########################
# @           @    D    #
# !    /    @           #
#  @!    @       #      #
#     !     #           #
#        @              #
#     @         #       #
#     @     #           #
#        !!   @         #
#    #                # #
#         #             #
#########################
