######
# j  #
#    #
#  @ #
######
######